######### ################ #########
######### ################ #########
#####                          #####
#####  ####### #####   ####### #####
##### ######## ##### ######### #####
##### #####  # ##### #####   # #####
#####  #####   ##### #####     #####
#####   #####  ##### #####     #####
#####    ##### ##### #####     #####
##### #   #### ##### #####   # #####
##### ######## ##### ######### #####
##### #######  #####   ####### #####
#####                          #####
######### ################ #########
######### ################ #########


####### ########## ##### ############# #######
####### ########## ##### ############# #######
#####   #####      ##### #####   #####   #####
#####   #####      ##### #####   #####   #####
#####   ########## ##### #####           #####
#####   ########## ##### #####           #####
#####        ##### ##### #####   #####   #####
#####        ##### ##### #####   #####   #####
####### ########## ##### ############# #######
####### ########## ##### ############# #######




  #######  ########### ##### #############  #######
  #######  ########### ##### #############  #######
  #####    ########### ##### #####   #####    #####
  #####    ######      ##### #####   #####    #####
  #####    ########### ##### #####   #####    #####
  #####    ########### ##### #####            #####
  #####          ##### ##### #####   #####    #####
  #####    ##### ##### ##### #####   #####    #####
  #####    ##### ##### ##### #####   #####    #####
  #######  ########### ##### #############  #######
  #######  ########### ##### #############  #######



########   #########  #####   ##########   ########
########  ##########  #####  ############  ########
#####     #####   ##  #####  #####  #####     #####
#####     #####    #  #####  #####  #####     #####
#####     #####       #####  #####            #####
#####      #####      #####  #####            #####
#####        #####    #####  #####            #####
#####          #####  #####  #####            #####
#####     #    #####  #####  #####  #####     #####
#####     ##   #####  #####  #####  #####     #####
########  ##########  #####  ############  ########
########  #########   #####   ##########   ########



   ######### ########### ##### ########### #########
   ######### ########### ##### ########### #########
   #####     ########### ##### ##### #####     #####
   #####     #####             ##### #####     #####
   #####     ########### ##### ##### #####     #####
   #####     ########### ##### #####           #####
   #####           ##### ##### ##### #####     #####
   #####     ##### ##### ##### ##### #####     #####
   #####     ##### ##### ##### ##### #####     #####
   ######### ########### ##### ########### #########
   ######### ########### ##### ########### #########

